+-----------------------------------------------------------------------------+
|+--------------------------------------------------------------------------+ |
||                                                                          | |
||                             Banner                                       | |
||                                                                          | |
|+--------------------------------------------------------------------------+ |
|+--------------------------------------------------------------------------+ |
||                                                                          | |
||                          Current Date                                    | |
||                                                                          | |
|+--------------------------------------------------------------------------+ |
|+--------------------------------------------------------------------------+ |
||+----------------------------------++-----------------------------------+ | |
|||                                  ||                                   | | |
|||                                  ||                                   | | |
|||     Dekatrian Calendar           ||        Gregorian Calendar         | | |
|||                                  ||                                   | | |
|||                                  ||                                   | | |
|||                                  ||                                   | | |
||+----------------------------------++-----------------------------------+ | |
|+--------------------------------------------------------------------------+ |
|+--------------------------------------------------------------------------+ |
||                                Footer                                    | |
|+--------------------------------------------------------------------------+ |
+-----------------------------------------------------------------------------+
